37 18
#############
#...........#    ###################
#...........######.................#
#..................................#
#...........######.................#
#...........#    #.................#
#...........#    #.................#
#...........#    #.................#
#####..######    ###################
    #..#
  ###..##################
  #.....................#
  #.....................#
  #.....................#
  #.....................#
  #.....................#
  #..........@..........#
  #######################