47 28
    #######################
    #.......t.....t.......#
    #.......t..@..t.......#
    #.....................#
    #.....................#
    #...a..........a......#
    #...REPEAT.....QUIT...#
    #.....................#
    #######################



















