25 20
       ##########
       #.R......#
       ####.....#
       #........#
       ####.....#
       #....@...#
       ####.....#
       #Q.......#
       #######..#
             #..#
             #..#
             ####
             #  #
             ####






