47 28
    #######################
    #.....................#
    #.....................#
    #........taPLAY.......#
    #.....................#
    #..@..................#
    #.....................#
    #........taQUIT.......#
    #.....................#
    #.....................#
    #######################



















