47 28
    #######################
    #.....................#
    #.....................#
    #.....................#
    #.....................#
    #..........Ű..........#
    #.....................#
    #.....................#
    #.....................#
    #.....................#
    #######################



















